##########
#*#..#.O*#
#.#O.#...#
#.#..#...#
#....#...#
#.....+.*#
########.#
#*######.#
#.O.O....#
#........#
##########

