#############
#*...#......#
#....#......#
###..#*.....#
#.....O..+..#
#....#....O.#
#.O..#####..#
#....#*.....#
#############
