#########
#.+######
#.#######
#.#######
#.#######
#.#######
#.#######
#.#######
#.#######
#.....O*#
#########
