##########
#*O..+.O*#
#........#
#........#
#.......O#
#.......*#
##########

