#####
#*###
#..##
#.O.#
#...#
#...#
#..+#
#*O.#
#####

