##########
#..+.....#
#.O.O.*..#
#...*....#
##########

