##########
#+.....O*#
#......O.#
#......*.#
##########
