##########
#+O.....*#
#......O.#
#......*.#
##########
