#######
#.....#
#O.*.O#
#..O..#
#.....#
#..+..#
#..O..#
#.....#
#*.*.*#
#######

