########
#..*...#
#..OO*.#
#.*O+..#
#......#
########
