########
#..*...#
#..Oo..#
#..o+..#
#......#
########
