##########
#.*......#
#..O....*#
#........#
#........#
#.O......#
#.+......#
##########
