###########
#*........#
#.........#
########..#
#+.#.O....#
#..#......#
#.........#
###########
