#########
#......*#
#.O.+.O.#
#*......#
#########
