#########
#+#######
#..######
##..#####
###..####
####..###
#####..##
######..#
#######O#
#######*#
#########
