###########
#....+....#
#....O....#
#*O.....O*#
#....*....#
#...*O....#
###########
