########
#*######
#..#####
#.O.####
#...####
#...####
#+.....#
#.O.O..#
#####..#
##**...#
########
