#############
#+......#...#
#.O.O.O.....#
########....#
#***........#
#############
